##########################
#    #                 #X#
#    #      *          #X#
#  * #                 # #
#  * #                   #
#           #        *   #
#       XX  #            #
#    #      #      R     #
#    #      #            #
#    #      #            #
#O   #      #    #       #
##########################